16 16 2 2 14 14
################
#++++++++++++++#
#++++++++++++++#
#++++++++++++++#
#++++++++++++++#
#++++++++++++++#
#++++++++++++++#
#++++++++++++++#
#++++++++++++++#
#++++++++++++++#
#++++++++++++++#
#++++++++++++++#
#++++++++++++++#
#++++++++++++++#
#++++++++++++++#
################